澳大利亚	Àodàlìyà	p.n.	Australia
趵突泉	Bàotū Quán	p.n.	Baotuquan, name of a spring
鲍全	Bào Quán	p.n.	Bao Quan, name of a person
菜市口	Càishìkǒu	p.n.	Caishikou, a place in Beijing
楚国	Chǔguó	p.n.	Kingdom of Chu
春秋	Chūnqiū	p.n.	Spring and Autumn Period (770 B.C. - 476 B.C.)
丹尼尔·卡内曼	Dānní'ěr Kǎnèimàn	p.n.	Daniel Kahneman
稻香村	Dàoxiāngcūn	p.n.	Daoxiangcun Bakery
东海龙王	Dōnghǎi Lóngwáng	p.n.	Dragon King of the East Sea
峰终定律	Fēngzhōng Dìnglǜ	p.n.	Peak-End Rule
广和居	Guǎnghéjū	p.n.	Guangheju Restaurant
华北	Huáběi	p.n.	north China
济南	Jǐ'nán	p.n.	Ji'nan, capital of Shandong Province
加利福尼亚州	Jiālìfúníyà Zhōu	p.n.	California
科恩	Kē'ēn	p.n.	Cohen, a surname
孔子	Kǒngzǐ	p.n.	Confucius, an ancient Chinese thinker and educator
李广	Lǐ Guǎng	p.n.	Li Guang (?-119 B.C.), a famous general
廉颇	Lián Pō	p.n.	Lian Po, a famous general
刘炽平	Liú Chìpíng	p.n.	Liu Chiping, president of Tencent
卢米埃尔	Lúmǐ'āi'ěr	p.n.	Lumière, a French surname
鲁迅	Lǔ Xùn	p.n.	Lu Xun (1881-1936), a famous Chinese writer
马萨诸塞州	Mǎsàzhūsài Zhōu	p.n.	Massachusetts
麦布里奇	Màibùlǐqí	p.n.	Eadweard Muybridge
梅西	Méixī	p.n.	Lionel Messi, a famous football player
《呐喊》	<Nàhǎn>	p.n.	Call to Arms, one of Lu Xun's short story collections
诺贝尔奖	Nuòbèi'ěr Jiǎng	p.n.	Nobel Prize
《彷徨》	Pánghuáng	p.n.	Wandering, one of Lu Xun's short story collections
七郎	Qīláng	p.n.	Qilang, name of a man
秦国	Qínguó	p.n.	State of Qin
舜	Shùn	p.n.	Shun, a legendary leader of ancient China
斯坦福	Sītǎnfú	p.n.	Leland Stanford
腾讯	Téngxùn	p.n.	Tencent, a Chinese company
微信	Wēixìn	p.n.	WeChat, a messaging and calling app
夕	Xī	p.n.	Xi, name of a monster
西汉	Xīhàn	p.n.	Western Han Dynasty (206 B.C. - 25 A.D.)
新西兰	Xīnxīlán	p.n.	New Zealand
杨雄	Yáng Xióng	p.n.	Yang Xiong (53 B.C. - 18 A.D.), a scholar
郁达夫	Yù Dáfū	p.n.	Yu Dafu (1896-1945), a famous Chinese writer
翟峰	Zhái Fēng	p.n.	Zhai Feng, name of a person
詹姆士·奈史密斯	Zhānmǔshì Nàishǐmìsī	p.n.	James Naismith
战国	Zhànguó	p.n.	Warring States Period (475 B.C. - 221 B.C.)
张小龙	Zhāng Xiǎolóng	p.n.	Zhang Xiaolong, senior vice president of Tencent
赵国	Zhàoguó	p.n.	State of Zhao
赵括	Zhào Kuò	p.n.	Zhao Kuo, son of Zhao She
赵奢	Zhào Shē	p.n.	Zhao She, a famous general
子路	Zǐlù	p.n.	Zilu, a disciple of Confucius
奔跑	bēnpǎo	v.	to run, to gallop
波动	bōdòng	v.	to undulate, to rise and fall
称霸	chēngbà	v.	to dominate, to maintain hegemony
代言	dàiyán	v.	to speak on behalf of, to star in a commercial
道具	dàojù	n.	stage property, prop
颠球	diān qiú		to juggle a soccer ball
叮	dīng	v.	to bite, to sting
恩爱	ēn'ài	adj.	(of husband and wife) loving
二手	èrshǒu	adj.	second-hand
帆船	fānchuán	n.	sailing boat/ship
放纵	fàngzòng	v.	to indulge, to be unrestrained
杆	gān	n.	pole, shaft
怪物	guàiwù	n.	monster
棍	gùn	n.	stick, cudgel
国君	guójūn	n.	king
海里	hǎilǐ	m.	sea mile
含意	hányì	n.	implied meaning, implication
行家	hángjia	n.	expert
黑猩猩	hēixīngxing	n.	chimpanzee
患难与共	huànnàn-yǔgòng		to share weal and woe
火成岩	huǒchéngyán	n.	igneous rock
机制	jīzhì	n.	mechanism
积蓄	jīxù	n./v.	savings; to save
箭	jiàn	n.	arrow
金鱼	jīnyú	n.	goldfish
精诚所至	jīngchéng suǒzhì
金石为开	jīnshí wéikāi
就餐	jiùcān	v.	to have one's meal
锯子	jùzi	n./v.	to cut with a saw; saw
锯	jù	n./v.	to cut with a saw; saw
困扰	kùnrǎo	v.	to trouble, to haunt
栏杆	lángān	n.	railing, balustrade
淋漓尽致	línlí-jìnzhì		fully, thoroughly
埋	mái	v.	to bury
盲人	mángrén	n.	blind person
美德	měidé	n.	virtue, goodness
蒙眬	ménglóng	adj.	drowsy, half asleep
民居	mínjū	n.	civilian dwelling
纳入	nàrù	v.	to include, to incorporate into
评委	píngwěi	n.	judge, member of a judging panel
起居	qǐjū	v.	daily life
青蛙	qīngwā	n.	frog
情趣	qíngqù	n.	emotional appeal, interest
全神贯注	quánshén-guànzhù		to concentrate on, to be absorbed in
入围	rùwéi	v.	to be shortlisted
摄入	shèrù	v.	to take in, to ingest
肾上腺素	shènshàngxiànsù	n.	adrenaline
生物钟	shēngwùzhōng	n.	biological clock
石灰岩	shíhuīyán	n.	limestone
手笔	shǒubǐ	n.	style (of handling affairs)
守	shǒu	v.	to guard, to defend
顺畅	shùnchàng	adj.	smooth, unhindered
四合院	sìhéyuàn	n.	quadrangle courtyard
蹄子	tízi	n.	hoof
蹄	tí	n.	hoof
天然	tiānrán	adj.	natural
涂鸦	túyā	v.	to scrawl
歪歪扭扭	wāiwāiniǔniǔ	adj.	crooked, askew
喂养	wèiyǎng	v.	to feed, to raise
蚊子	wénzi	n.	mosquito
相敬如宾	xiāngjìng-rúbīn		(of husband and wife) to respect each other like guests
厢房	xiāngfáng	n.	wing, wing room
橡子	xiàngzi	n.	acorn
孝敬	xiàojìng	v.	to show filial respect for
悠悠	yōuyōu	adj.	leisurely, unhurried
由来	yóulái	n.	origin, source
寓言	yùyán	n.	fable
朝三暮四	zhāosān-mùsì		to give three in the morning and four in the evening--to play fast and loose, to chop and change
哲学家	zhéxuéjiā	n.	philosopher
镇	zhèn	n.	town
纸上谈兵	zhǐshàng-tánbīng		to be an armchair strategist
种	zhòng	v.	to plant, to grow
# HSK5下
北京师范大学	Beijing Shifan Daxue
比尔·盖茨	Bǐ'ěr Gàicí	p.n.	Bill Gates	[textbook spelling]
比尔·盖茨	Bǐ'ěr`Gàicí	p.n.	Bill Gates	[macOS IME spelling]
《非你莫属》	<Fēinǐmòshǔ>	p.n.	Only You, a job hunting reality show	[macOS IME spelling]
《非你莫属》	Fēinǐmòshǔ	p.n.	Only You, a job hunting reality show	[textbook spelling]
国贸	Guomao
鼓楼大街	Gulou Dajie
郝林说	Hao Linshuo
护国寺	Huguosi
灰姑娘	Huiguniang
健伟	Jianwei
老舍	Lao She
里查德·希尔斯	Lichade Xi'ersi	p.n.	Richard Sears	[textbook spelling]
里查德·希尔斯	Lichade`Xi'ersi	p.n.	Richard Sears	[macOS IME spelling]
刘辰	Liu Chen
洛杉矶	Luoshanji
《卖火柴的小女孩儿》	<Mài Huǒchái de Xiǎo Nǚháier>	p.n.	The Little Match Girl, a short story by the Danish author H.C. Andersen	[macOS IME spelling]
《卖火柴的小女孩儿》	Mài Huǒchái de Xiǎo Nǚháir	p.n.	The Little Match Girl, a short story by the Danish author H.C. Andersen	[textbook spelling]
牛津大学	Niujin Daxue
欧盟	Ōu Méng	p.n.	European Union
欧洲环境保护署	Ōuzhōu Huánjìng Bǎohù Shǔ	p.n.	European Environment Agency
潘家园	Panjiayuan
佩·詹森	Pèi Zhānsēn	p.n.	Pay Jensen, name of person	[textbook spelling]
佩·詹森	Pèi`Zhānsēn	p.n.	Pay Jensen, name of person	[macOS IME spelling]
《说文解字》	Shuōwén Jiězì	p.n.	Shuowen Jiezi, literally "Explaining and Analyzing Characters", an early 2nd century dictionary of Chinese characters	[textbook spelling]
《说文解字》	<Shuōwén Jiězì>	p.n.	Shuowen Jiezi, literally "Explaining and Analyzing Characters", an early 2nd century dictionary of Chinese characters	[macOS IME spelling]
天安门东	Tian'anmen Dong
天津卫视	Tianjin Weishi
文文	Wenwen
夏威夷	Xiaweiyi
印加	Yinjia
云南	Yunnan
赵福根	Zhao Fugen
八成儿	bachengr
八成	bacheng
般	bān	part.	sort, kind
暴雨	baoyu
闭关	biguan
不假思索	bùjiǎ-sīsuǒ
才艺	caiyi
查询	chaxun
车祸	chehuo
沉	chén	v.	to sink
诚信	chengxin
抽	chōu	v.	to draw, to obtain by drawing
创办	chuangban
丛林	conglin
存活	cunhuo
额	é	n.	specified number, sum, volume or amount
反省	fanxing
返航	fanhang
犯	fàn	v.	to commit (an error, crime, etc.)
分享	fenxiang
风浪	fenglang
负重	fuzhong
擀	gǎn	v.	to roll (dough etc. with a rolling pin)
根基	genji
根治	genzhi
雇	gù	v.	to employ, to hire
汗腺	hanxian
和尚	heshang
糊	hú	v.	to be burnt
寄生	jisheng
佳	jiā	adj.	good, fine
家访	jiafang
健步如飞	jiànbù-rúfēi
焦	jiāo	adj.	burnt, scorched
局	jú	m.	game, set
菊花	juhua
垮	kuǎ	v.	to collapse, to break down
来	lái	part.	used after round numbers to indicate approximation
老鹰	laoying
连环画	lianhuanhua
留守	liushou
屡	lǚ	adv.	repeatedly, time and again
萝卜	luobo
毛孔	maokong
冒	mào	v.	to emit, to give off, to send out
门槛	menkan
鲇鱼	nianyu
棚子	pengzi
青壮年	qīng-zhuàngnián
情侣	qínglǚ
情缘	qingyuan
请愿书	qingyuanshu
沙丁鱼	shadingyu
沙子	shazi
赏心悦目	shǎngxīn-yuèmù
少许	shaoxu
身段	shenduan
深渊	shenyuan
施肥	shi fei
适当	shidang
收集	shōují	v.	to collect, to gather
丝	sī	n.	shred, anything threadlike
昙花	tanhua
痰	tán	n.	phlegm, sputum
天敌	tiandi
图	tú	v.	to covet, to be after
万丈	wanzhang
王宫	wanggong
旺盛	wangsheng
微博	wēibó	n.	microblog
尾气	weiqi
文火	wenhuo
无意	wuyi
洗礼	xili
效应	xiaoying
一连	yilian
荫凉	yinliang
招儿	zhāor	n.	trick, move, method	[textbook spelling 1]
招	zhāo	n.	trick, move, method	[textbook spelling 2]
折叠	zhédié	v.	to fold
哲理	zheli
蒸腾	zhengteng
支教	zhi jiao
枝干	zhīgàn	n.	branch, limb
知感	zhīgǎn	n.	sense, perception
知更鸟	zhigengniao
制订	zhiding
钟	zhōng	n.	bell
专注	zhuanzhu
转头	zhuantou
啄	zhuó	v.	to peck
