# HSK5上
哎	ai
唉	ai
爱护	aihu
安慰	anwei
安装	anzhuang
暗暗	an'an
熬夜	ao ye
摆	bai
半夜	banye
傍晚	bangwan
包括	baokuo
宝贝	baobei
宝贵	baogui
保存	baocun
报道	baodao
抱怨	baoyuan
背	bei
背景	beijing
被子	beizi
本领	benling
彼此	bici
必要	biyao
毕竟	bijing
避免	bimian
鞭炮	bianpao
便	bian
辩论	bianlun
表达	biaoda
表面	biaomian
表明	biaoming
表情	biaoqing
表现	biaoxian
播放	bofang
脖子	bozi
不耐烦	bu naifan
不要紧	bu yaojin
不得了	budeliao
不行	buxing
不足	buzu
布	bu
财产	caichan
采取	caiqu
采用	caiyong
彩虹	caihong
踩	cai
参与	canyu
惭愧	cankui
躲藏	duocang
操场	caochang
曾经	cengjing
差距	chaju
差异	chayi
插	cha
产品	chanpin
产生	chansheng
长途	changtu
吵	chao
吵架	chao jia
称	chēng	v.	to call, to give sb. a particular name
称	chēng	v.	to weigh
成果	chengguo
成就	chengjiu
成熟	chengshu
成语	chengyu
诚恳	chengken
程度	chengdu
吃亏	chi kui
迟早	chizao
持续	chixu
冲	chong
充分	chongfen
充满	chongman
重复	chongfu
宠物	chongwu
抽象	chouxiang
丑陋	choulou
出自	chuzi
除	chu
除夕	chuxi
传说	chuanshuo
传统	chuantong
窗帘	chuanglian
创造	chuangzao
词汇	cihui
辞职	ci zhi
此外	ciwai
从而	cong'er
从前	congqian
催	cui
存在	cunzai
措施	cuoshi
达到	da dao
打工	da gong
打交道	da jiaodao
打听	dating
大方	dafang
呆	dai
代表	daibiao
待遇	daiyu
胆小鬼	danxiaogui
当地	dangdi
挡	dang
导演	daoyan
导致	daozhi
倒	dao
道理	daoli
等待	dengdai
等于	dengyu
低落	diluo
敌人	diren
地道	didao
地区	diqu
地位	diwei
递	di
点心	dianxin
电台	diantai
钓	diao
顶	ding
冻	dong
洞	dong
逗	dou
独立	duli
独特	dute
度过	duguo
断	duan
断断续续	duanduan-xuxu
对比	duibi
对方	duifang
蹲	dun
顿	dun
多亏	duokui
发愁	fa chou
发达	fada
反而	fan'er
反应	fǎnyìng	n./v.	response; to respond, to react	[merged with duplicate in 5下]
反映	fǎnyìng	v.	to reflect, to mirror
方	fang
方案	fang'an
方式	fangshi
仿佛	fangfu
非	fei	v.	to be not
分别	fenbie
分布	fenbu
分析	fenxi
纷纷	fenfen
风俗	fengsu
疯	feng
讽刺	fengci
扶	fu
服装	fuzhuang
幅	fu
改进	gaijin
赶紧	ganjin
感激	ganji
感受	ganshou
干活儿	gan huor	v.	to work
干活儿	gan huoer	v.	to work
高档	gaodang
高级	gaoji
告别	gaobie
格外	gewai
个别	gebie
个人	geren
各自	gezi
根	gēn	m./n.	root, foundation; a measure word for long and thin objects	[merged with duplicate in 5下]
工程师	gongchengshi
工具	gongju
工人	gongren
公元	gongyuan
功能	gongneng
姑姑	gugu
姑娘	guniang
古代	gudai
古典	gudian
骨头	gutou	n.	bone
固定	guding
关闭	guanbi
官	guan
光临	guanglin
光线	guangxian
广大	guangda
广泛	guangfan
规律	guīlǜ
规则	guize
锅	guō	n.	pot, pan
果然	guoran
果实	guoshi
哈	hā	onom./int.	sound of laughter; indicating complacency or satisfaction
海鲜	haixian
喊	hǎn	v.	to shout, to call
豪华	haohua
好客	haoke
好奇	haoqi
合作	hezuo
何必	hebi
何况	hekuang
很	hèn	v.	to hate
猴子	houzi
后背	houbei
呼朋唤友	hupeng huanyou
呼吸	huxi
忽然	huran
忽视	hushi
胡说	hushuo
胡同	hutong
壶	hú	n.	pot, kettle
糊涂	hutu
华裔	huayi
滑	huá	adj./v.	slippery; to slip, to slide
话题	huati
慌	huāng	adj.	flurried, flustered
慌张	huāngzhāng	adj.	flurried, flustered	[merged with duplicate in 5下]
灰尘	huichen
挥	huī	v.	to wave, to weild
婚礼	hunli
婚姻	hunyin
活跃	huoyue
伙伴	huoban
或许	huoxu
击	jī	v.	to hit, to strike
机器	jīqì	n.	machine
激烈	jilie
极其	jíqí	adv.	extremely
即	jí	v./adv.	to be; namely
集中	jizhong
计算	jisuan
记忆	jiyi
纪念	jinian
系	jì	v.	to tie, to fasten
家庭	jiating
甲	jiǎ	n.	first
驾驶	jiashi
坚决	jianjue
肩膀	jianbang
艰苦	jianku
建筑	jianzhu
讲究	jiangjiu
交际	jiaoji
角度	jiaodu
结实	jieshi
接待	jiedai
节省	jiesheng
节食	jieshi
结构	jiegou
结论	jielun
戒	jiè	v.	to give up, to quit
借口	jiekou
金属	jinshu
尽	jìn	v.	to try one's best
尽力	jìnlì	v.	to try one's best
近代	jindai
经营	jingying
精神	jīngshén	n.	spirit, essence	[textbook + dictionary]
精神	jīngshen	n./adj.	energy, vigor; lively, vigorous	[textbook + dictionary]
救	jiù	v.	to save, to rescue
舅舅	jiujiu
居然	juran
具备	jubei
决心	juexin
绝对	juedui
军事	junshi
开发	kaifa
开幕式	kaimushi
靠	kào	v.	to lean against
颗	kē	m.	used for things small and roundish
可见	kejian
可靠	kekao
空间	kongjian
啦	la	part.	combination of the sounds of "了(le)" and "啊(a)", expressing exclamation, interrogation, etc.
拦	lán	v.	to block, to hold back
烂	làn	adj.	bad, lame
劳动	laodong
老百姓	laobaixing
老婆	laopo
老实	lǎoshi	adj.	honest, frank
姥姥	laolao
雷	léi	n.	thunder
类型	leixing
离婚	lihun
理论	lilun
立即	lìjí	adv.	immediately, at once
立刻	lìkè	adv.	at once, immediately
连忙	liánmáng	adv.	promptly, at once
连续	lianxu
联合	lianhe
良好	lianghao
粮食	liangshi
亮	liàng	adj./v.	bright; to shine
临	lín	prep.	about to, just before
临时	linshi
灵活	linghuo
铃	líng	n.	bell
令	lìng	v.	to make, to cause
流传	liuchuan
流泪	liu lei
龙	lóng	n.	dragon
漏	lòu	v.	(of a container) to leak
陆地	ludi
轮	lún	v.	to take turns
轮流	lúnliú	v.	to take turns
骂	mà	v.	to curse, to call names
馒头	mantou
满足	manzu
毛病	maobing
矛盾	maodun
美术	meishu
魅力	meili
苗条	miaotiao
描写	miaoxie
明明	mingming
明显	mingxian
明星	mingxing
命令	mingling
摸	mō	v.	to touch, to feel, to stroke
模仿	mofang
目前	muqian
哪怕	napa
脑袋	naodai
闹钟	nàozhōng	n.	alarm clock
宁可	ningke
农村	nongcun
农民	nongmin
浓	nóng	adj.	strong, deep
女士	nǚshì	n.	lady, madam
拍	pāi	v.	to take (a photo), to shoot (a video)
派	pài	v.	to send, to assign, to appoint
派	pài	n.	faction, school, group of people sharing identical ideas, style or tastes
盼望	panwang
盆	pén	n.	basin, tub
盆子	pénzi	n.	basin, tub
碰	pèng	v.	to meet, to come across
匹	pǐ	m.	used for horses
片面	pianmian
飘	piāo	v.	to float (in the air), to waft
平	píng	adj.	flat, level
平常	pingchang
平静	pingjing
平均	pingjun
评价	pingjia
其余	qiyu
奇迹	qiji
企业	qiye
启发	qifa
气氛	qifen
签	qiān	v.	to sign, to autograph
浅	qiǎn	adj.	shallow, light
强烈	qianglie
墙	qiáng	n.	wall
抢	qiǎng	v.	to rob, to snatch
悄悄	qiaoqiao
瞧	qiáo	v.	to look, to see
亲切	qinqie
亲自	qinzi
勤奋	qinfen
轻视	qingshi
情景	qingjing
情绪	qingxu
请求	qingqiu
球迷	qiumi
趋势	qūshì	n.	trend, tendency
去世	qùshì	v.	to die, to pass away
缺乏	quēfá	v.	to lack, to be short of	[merged with duplicate in 5下]
确定	queding
确认	queren
群	qún	m.	group, herd, flock
人才	rencai
人类	renlei
人民	renmin
人生	rensheng
人员	renyuan
日常	richang
日子	rizi
如何	ruhe
如今	rujin
弱	ruò	adj.	weak
洒	sǎ	v.	to sprinkle, to spray
杀	shā	v.	to kill
晒	shài	v.	to dry in the sun
闪电	shandian
扇子	shànzi	n.	fan
善良	shanliang
善于	shanyu
伤害	shānghài	v.	to hurt, to harm
上当	shang dang
设计	shèjì	v./n.	to design; design
射	shè	v.	to shoot
射击	shèjī	v.	to shoot
摄影师	sheyingshi
伸	shēn	v.	to stretch, to extend
身份	shenfen
深刻	shenke
神秘	shenmi
升	shēng	v.	to rise, to go up
绳子	shengzi
胜利	shengli
失眠	shimian
诗	shī	n.	poem
石头	shitou
时代	shidai
时刻	shike
时期	shiqi
时尚	shishang
实现	shixian
实验	shiyan
食物	shiwu
始终	shizhong
士兵	shibing
市场	shichang
似的	shide
事实	shìshí	n.	fact
事物	shiwu
手指	shouzhi
守岁	shousui
首	shǒu	n.	head, first
舒适	shushi
蔬菜	shucai
数	shù	num.	several
甩	shuǎi	v.	to throw off, to swing
说不定	shuobuding
说服	shuofu
似乎	sihu
算	suàn	v.	to regard as, to count as
随时	suishi
随手	suishou
碎	suì	v./adj.	to break into pieces; broken, fragmentary
所	suǒ	part.	used before a verb followed by a noun which is the receiver of the action
所谓	suowei
锁	suǒ	n./v.	lock; to lock up
台阶	taijie
太太	taitai
逃	táo	v.	to escape
桃	táo	n.	peach
淘气	taoqi
套	tào	m.	set, suite
体会	tǐhuì	v./n.	to learn from experience, to realize; feeling, understanding	[merged with duplicate in 5下]
代替	dàitì	prep.	for, on behalf of
替	tì	prep.	for, on behalf of
天真	tianzhen
调皮	tiaopi
调整	tiaozheng
挑战	tiaozhan
通常	tongchang
投篮	tou lan
投入	touru
突出	tuchu
推广	tuiguang
推荐	tuijian
外公	waigong
完整	wanzheng
危害	weihai
微笑	weixiao
为	wéi	v.	to become
为	wéi	prep.	(often used together with "所 (suǒ)" by (sb.)
围绕	weirao
尾巴	weiba
委屈	weiqu
未来	weilai
位于	weiyu
位置	weizhi
胃	wèi	n.	stomach
胃口	weikou
温暖	wennuan
文学家	wenxuejia
文字	wenzi
稳定	wending
卧室	woshi
屋子	wūzi	n.	house
屋	wū	n.	house
无奈	wunai
勿	wù	adv.	(used in imperative sentences) don't
物质	wuzhi
戏剧	xiju
细节	xijie
瞎	xiā	v./adv.	to be blind; blindly, foolishly
吓	xià	v.	to frighten, to scare
显得	xiande
显示	xianshi
县	xiàn	n.	county
现代	xiandai
现实	xianshi
现象	xianxiang
限制	xianzhi
相处	xiangchu
相当	xiangdang
相对	xiangdui
相关	xiangguan
享受	xiangshou
想象	xiangxiang
项	xiàng	m.	used for itemized things
项目	xiangmu
大象	dàxiàng	n.	elephant
象	xiàng	n.	elephant
消费	xiaofei
销售	xiaoshou
孝顺	xiaoshun
斜	xié	adj.	oblique, slanting
写作	xiezuo
心理	xinli
欣赏	xinshang
行为	xingwei
形成	xingcheng
形容	xingrong
形式	xíngshì	n.	form, mode
形势	xíngshì	n.	situation, state of affairs
形象	xingxiang
形状	xingzhuang
兄弟	xiongdi
叙述	xushu
宣传	xuanchuan
学问	xuewen
寻找	xunzhao
询问	xunwen
训练	xunlian
迅速	xunsu
牙齿	yachi
样式	yangshi
摇	yáo	v.	to wave, to shake
咬	yǎo	v.	to bite
要不	yaobu
业务	yewu
业余	yeyu
夜	yè	n.	night
依然	yiran
一辈子	yibeizi
一再	yizai
移动	yidong
移民	yimin
乙	yǐ	n.	second (of counting)	[see 天干]
以	yǐ	conj.	in order to, so as to
以及	yiji
以来	yilai
亿	yì	num.	hundred million
意外	yiwai
意义	yiyi
因而	yīn'ér	conj.	therefore, thus
银子	yínzi	n.	silver
银	yín	n.	silver
英俊	yingjun
英雄	yingxiong
营养	yingyang
影子	yingzi
应用	yingyong
硬	yìng	adj.	hard, tough
拥抱	yongbao
用途	yongtu
优美	youmei
悠久	youjiu
幼儿园	yòu'éryuán	n.	kindergarten
于	yú	prep.	from, out of
愿望	yuanwang
晕	yūn	v.	to faint, to pass out
运用	yunyong
灾害	zaihai
再三	zaisan
赞美	zanmei	v.	to praise, to extol	[dictionary spelling: zànměi]
赞美	zanmai	v.	to praise, to extol	[book spelling: zànmǎi; error?]
糟糕	zaogao
造成	zaocheng
则	zé	m.	(used for news or writings) piece
则	zé	conj.	(indicating contrast) while
占	zhàn	v.	to occupy, to take, to hold, to make up
战争	zhanzheng
长辈	zhangbei
招待	zhaodai
着火	zhao huo
召开	zhaokai
针对	zhendui
阵	zhèn	m.	used for a short period or spell of an occurrence or action
争论	zhenglun
争取	zhengqu
整个	zhengge
整体	zhengti
证据	zhengju
挣	zhèng	v.	to earn
支	zhī	m.	used for long, thin, inflexible objects
至今	zhijin
志愿者	zhiyuanzhe
制造	zhizao
治疗	zhìliáo	v.	to treat, to cure
治	zhì	v.	to treat, to cure
智慧	zhihui
中心	zhongxin
重大	zhongda
猪	zhū	n.	pig
竹子	zhúzi	n.	bamboo
逐渐	zhujian
主持	zhuchi
主动	zhudong
主人	zhuren
注册	zhuce
专家	zhuanjia
装	zhuāng	v.	to load, to hold
装修	zhuangxiu
状态	zhuangtai
撞	zhuàng	v.	to bump against
追	zhuī	v.	to chase, to go after
姿势	zishi
资格	zige
资料	ziliao
自杀	zisha
自由	ziyou
综合	zonghe
总裁	zongcai
总共	zonggong
阻止	zuzhi
组	zǔ	n./m.	group, team, set
组成	zucheng
组合	zuhe
醉	zuì	v.	to be drunk
作品	zuopin
作为	zuowei
作战	zuozhan
# HSK5下
爱惜	aixi
爱心	aixin
岸	àn	n.	bank (of a river, lake, etc.), shore, coast
暗	àn	adj.	dark, dim
把握	bawo
办理	banli
包含	baohan
薄	báo	adj.	thin
保留	baoliu
保险	baoxian
报告	baogao
报社	baoshe
悲伤	bēishāng	adj.	sad, sorrowful
悲	bēi	adj.	sad, sorrowful
本科	benke
本质	benzhi
比例	bili
必然	biran
编辑	bianji
标志	biaozhi
冰激凌	bingjiling
玻璃	boli
不断	buduan
不见得	bujiande
补充	buchong
不安	bù'ān	adj.	upset, disturbed
不然	buran
不如	buru
步骤	buzhou
部门	bumen
采访	caifang
参考	cankao
操心	cao xin
册	cè	m.	volume
测验	ceyan
常识	changshi
朝	cháo	prep.	towards
潮湿	chaoshi
炒	chǎo	v.	to stir-fry
彻底	chedi
沉默	chenmo
趁	chèn	prep.	to take advantage of, (to do...) at the time when
称呼	chenghu
称赞	chengzan
成分	chengfen
成立	chengli
成人	chengren
成长	chengzhang
承担	chengdan
承认	chengren
承受	chengshou
池塘	chitang
翅膀	chibang
出版	chuban
出色	chuse
出示	chushi
出席	chuxi
初级中学	chūjí zhōngxué	n.	junior high school
初中	chūzhōng	n.	junior high school
除非	chufei
处理	chuli
闯	chuǎng	v.	to go around (to accomplish certain goals)
吹	chuī	v.	to boast, to brag
次要	ciyao
刺激	ciji
从此	congci
从事	congshi
粗糙	cucao
促进	cujin
促使	cushi
醋	cù	n.	vinegar
答应	daying
大厦	dasha
大型	daxing
担任	danren
单纯	danchun
单调	dandiao
单独	dandu
单位	danwei
耽误	danwu
岛屿	daoyu
倒霉	dao mei
到达	daoda
道德	daode
登记	dengji
的确	dique
地理	dili
地震	dizhen
电池	dianchi
动画片	donghuapian
堆	dui	m.	heap, pack, pile
对待	duidai
对手	duishou
对象	duixiang
吨	dūn	m.	metric ton
朵	duǒ	m.	used for flowers and clouds
恶劣	elie
发抖	fadou
发挥	fahui
发言	fa yan
翻	fān	v.	to turn (over)
繁荣	fanrong
反复	fanfu
反正	fanzheng
范围	fanwei
妨碍	fáng'ài	v.	to hinder, to impede
肥皂	feizao
废	fèi	adj.	waste, useless
奋斗	fendou
风景	fēngjǐng	n.	scenery, view
风险	fengxian
否认	fouren
妇女	fùnǚ	n.	woman
改革	gaige
改善	gaishan
盖	gài	v./n.	to cover; lid, cover
概括	gaikuo
概念	gainian
干脆	gancui
干燥	ganzao
赶快	gankuai
感想	ganxiang
钢铁	gangtie
搞	gǎo	v.	(followed by a complement) to produce a certain effect or result
个性	gexing
根本	genben
工厂	gongchang
工业	gongye
公布	gongbu
公开	gongkai
公寓	gongyu
贡献	gongxian
沟通	goutong
构成	goucheng
鼓舞	guwu
鼓掌	gu zhang
乖	guāi	adj.	obedient, well-behaved
观察	guancha
观点	guandian
观念	guannian
馆子	guanzi
冠军	guanjun
光滑	guanghua
光明	guangming
广场	guangchang
归纳	guina
规矩	guiju
滚	gǔn	v.	to roll, to tumble
过分	guofen
行业	hangye
合理	heli
和平	heping
核心	hexin
后果	houguo
蝴蝶	hudie
怀念	huainian
缓解	huanjie
幻想	huanxiang
灰	huī	n./adj.	dust; gray
灰心	huixin
恢复	huifu
火柴	huochai
肌肉	jirou
基本	jiben
及格	ji ge
挤	jǐ	v.	to squeeze out, to push out
记录	jìlù	n./v.	record, note; to record
纪录	jìlù	n./v.	record, note; to record, to note down
纪律	jìlǜ	n.	discipline, rule
寂寞	jimo
家务	jiawu
家乡	jiaxiang
假如	jiaru
假设	jiashe
价值	jiazhi
艰巨	jianju
捡	jiǎn	v.	to pick up, to collect
剪刀	jiandao
简历	jianli
简直	jianzhi
建立	jianli
建设	jianshe
健身	jianshen
讲座	jiangzuo
酱油	jiangyou
交换	jiaohuan
交往	jiaowang
浇	jiāo	v.	to water, to pour (liquid on sth.)
狡猾	jiaohua
教练	jiaolian
教训	jiaoxun
阶段	jieduan
接触	jiechu
接近	jiejin
结合	jiehe
届	jiè	m.	session, year, class
尽快	jinkuai
尽量	jinliang
紧急	jinji
谨慎	jinshen
进步	jinbu
经典	jingdian
经商	jingshang
酒吧	jiuba
橘子	juzi
巨大	juda
具体	juti
据说	jushuo
决赛	juesai
角色	juese
均匀	junyun
开放	kaifang
开水	kaishui
砍	kǎn	v.	to cut, to chop, to fell
看不起	kanbuqi
可怕	kepa
克服	kefu
刻苦	keku
客观	keguan
空闲	kongxian
控制	kongzhi
口味	kouwei
库	kù	n.	storehouse, bank
夸	kuā	v.	to praise
夸张	kuazhang
宽	kuān	adj.	wide, broad
狂	kuáng	adj.	wildly, unrestrainedly
昆虫	kunchong
扩大	kuòdà	v.	to enlarge, to expand, to broaden
扩	kuò	v.	to enlarge, to expand, to broaden
朗读	langdu
劳驾	lao jia
老板	laoban
乐观	leguan
冷淡	lengdan
梨	lí	n.	pear
理由	liyou
力量	liliang
利润	lirun
利益	liyi
利用	liyong
恋爱	liàn'ài	n.	(romantic) love
了不起	liaobuqi
领域	lingyu
陆续	luxu
录取	luqu
逻辑	luoji
落后	luohou
冒险	mao xian
媒体	meiti
煤炭	meitan
梦想	mengxiang
秘密	mimi
密切	miqie
面对	miànduì	v.	to face, to confront
面积	mianji
面临	mianlin
敏感	mingan
名牌	mingpai
明确	mingque
命运	mingyun
模糊	mohu
陌生	mosheng
某	mǒu	pron.	some, certain
木头	mutou
目标	mubiao
难怪	nanguai
难免	nanmian
内部	neibu
嫩	nèn	adj.	soft, tender
能干	nenggan
能源	nengyuan
嗯	ǹg	int.	used to indicate positive response	[textbook & dictionary spelling]
嗯	en	int.	used to indicate positive response	[macOS IME spelling (ng does not work)]
年代	niandai
年纪	nianji
念	niàn	v.	to study
农业	nongye
偶然	ouran
培训	peixun
培养	peiyang
赔偿	peichang
佩服	peifu
批	pī	m.	group, batch
批准	peizhun
疲劳	pilao
片	piàn	n.	flat and thin piece
平安	píng'ān	adj.	safe, well
平等	pingdeng
平衡	pingheng
凭	píng	v./prep.	to rely on; on the basis of
迫切	poqie
破坏	pohuai
期待	qidai
期间	qijian
象棋	xiàngqí	n.	(Chinese) chess, board game	[textbook spelling 1]
棋	qí	n.	(Chinese) chess, board game	[textbook spelling 2]
起	qǐ	m.	case, instance
汽油	qiyou
谦虚	qianxu
前途	qiantu
强调	qiangdiao
巧妙	qiaomiao
切	qiē	v.	to cut, to chop, to slice
亲爱	qīn'ài	adj.	dear, beloved
青	qīng	adj.	greenish blue
青少年	qīng-shàonián	n.	younsters, teenagers
轻易	qingyi
清淡	qingdan
庆祝	qingzhu
取消	quxiao
圈	quān	n.	circle, ring
全面	quanmian
劝	quàn	v.	to try to persuade
燃烧	ranshao
热爱	rè'ài	v.	to love ardently
热烈	relie
热心	rexin
人物	renwu
忍不住	renbuzhu
日程	richeng
日用品	riyongpin
色彩	secai
沙漠	shamo
沙滩	shatan
傻	shǎ	adj.	stupid, foolish
商品	shangpin
商务	shangwu
商业	shangye
舍不得	shebude
设备	shebei
设施	sheshi
身材	shencai
生产	shengchan
生长	shengzhang
失去	shiqu
湿润	shirun
实话	shihua
实践	shijian
实用	shiyong
使劲儿	shǐjìnr	v.	to exert oneself, to make efforts	[textbook spelling 1]
使劲	shǐjìn	v.	to exert oneself, to make efforts	[textbook spelling 2]
事先	shixian
收获	shouhuo
手续	shouxu
受伤	shòushāng	v.	to be hurt, to be injured	[textbook spelling 1]
受	shòu	v.	to be hurt, to be injured	[textbook spelling 2]
梳子	shuzi
输入	shuru
熟练	shulian
属于	shuyu
数据	shuju
摔倒	shuaidao
丝毫	sihao
私人	sīrén	n.	private	[textbook spelling 1]
私	sī	n.	private	[textbook spelling 2]
思考	sikao
思想	sixiang
随身	suishen
损失	sunshi
缩短	suoduan
烫	tàng	v./adj.	to scald, to burn; very hot, scalding
逃避	taobi
特色	tese
特殊	teshu
特征	tezheng
疼爱	téng'ài	v.	to love dearly
提倡	tichang
提问	tiwen
题目	timu
体贴	titie
体现	tixian
体验	tiyan
天空	tiankong
痛苦	tongku
痛快	tongkuai
投资	tou zi
透明	touming
退休	tui xiu
外交	waijiao
完美	wanmei
完善	wanshan
万一	wanyi
王子	wangzi
网络	wangluo
威胁	weixia
违反	weifan
唯一	weiyi
未必	weibi
温柔	wenrou
文具	wenju
文明	wenming
闻	wén	v.	to smell
吻	wěn	v.	to kiss
无数	wushu
无所谓	wusuowei
物理	wuli
吸取	xiqu
吸收	xishou
系	xì	n.	department (of a university)
系统	xitong
下载	xiazai
鲜艳	xianyan
显然	xianran
相似	xiangsi
想念	xiangnian
消极	xiaoji
消失	xiaoshi
效率	xiàolǜ	n.	efficiency
歇	xiē	v.	to rest, to take a rest
心脏	xinzang
行动	xingdong
行人	xingren
幸亏	xingkui
幸运	xingyun
胸	xiōng	n.	chest, bosom
休闲	xiuxian
虚心	xuxin
押金	yajin
延长	yanchang
严肃	yansu
养	yǎng	v.	to raise, to keep, to grow
腰	yāo	n.	waist
一旦	yidan
一律	yílǜ	adv.	all, without exception
一致	yizhi
遗憾	yihan
疑问	yiwen
义务	yiwu
因素	yinsu
印刷	yinshua
迎接	yingjie
营业	yingye
应付	yingfu
硬	yìng	adv.	rigidly, mechanically
拥挤	yongji
勇气	yongqi
用功	yonggong
优势	youshi
犹豫	youyu
油炸	youzha
游览	youlan
有利	youli
娱乐	youle
与其	youqi
预防	yufang
元旦	yuandan
员工	yuangong
原料	yuanliao
原则	yuanze
圆	yuán	adj.	round, circular
运气	yunqi
运输	yunshu
在乎	zaihu
在于	zaiyu
赞成	zancheng
责备	zebei
窄	zhǎi	adj.	narrow
展开	zhankai
涨	zhǎng	v.	to rise, to go up
掌握	zhangwo
照常	zhaochang
珍惜	zhenxi
真实	zhenshi
征求	zhengqiu
睁	zhēng	v.	to open one's eyes
整齐	zhengqi
政府	zhengfu
支	zhī	v.	to prop up, to support
直	zhí	adv.	continuously, straight
指导	zhidao
指挥	zhihui
至于	zhiyu
制作	zhizuo
秩序	zhixu
中旬	zhongxun
种类	zhonglei
重量	zhongliang
逐步	zhubu
主观	zhuguan
主题	zhuti
主席	zhuxi
主张	zhuzhang
煮	zhǔ	v.	to boil, to stew
抓	zhuā	v.	to grab, to seize
抓紧	zhua jin
转变	zhuanbian
装饰	zhuangshi
状况	zhuangkuang
追求	zhuiqiu
咨询	zixun
资金	zijin
资源	ziyuan
紫	zǐ	adj.	purple
自从	zicong
自动	zidong
自豪	zihao
自觉	zijue
自私	zisi
自愿	ziyuan
总算	zongsuan
总之	zongzhi
组织	zuzhi
最初	zuichu
尊敬	zunjing
遵守	zunshou
作文	zuowen
# HSK5 words on test list but not listed in either of HSK5上 or HSK5下 appendix
包裹	bāoguǒ
保持	bǎochí
报到	bàodào
悲观	bēiguān
标点	biāodiǎn
病毒	bìngdú
博物馆	bówùguǎn
叉子	chāzi
拆	chāi
抄	chāo
超级	chāojí
车库	chēkù
车厢	chēxiāng
程序	chéngxù
尺子	chǐzi
充电器	chōngdiàn qì
抽屉	chōuti
丑	chǒu
臭	chòu
出口	chūkǒu
初级	chūjí
传播	chuánbō
传染	chuánrǎn
匆忙	cōngmáng
打喷嚏	dǎ pēntì
贷款	dàikuǎn
单元	dānyuán
淡	dàn
当心	dāngxīn
滴	dī
地毯	dìtǎn
豆腐	dòufu
兑换	duìhuàn
多余	duōyú
耳环	ěrhuán
发表	fābiǎo
发明	fāmíng
发票	fāpiào
罚款	fákuǎn
法院	fǎyuàn
废话	fèihuà
分配	fēnpèi
分手	fēnshǒu
风格	fēnggé
疯狂	fēngkuáng
否定	fǒudìng
辅导	fǔdǎo
复制	fùzhì
改正	gǎizhèng
隔壁	gébì
公平	gōngpíng
公主	gōngzhǔ
恭喜	gōngxǐ
股票	gǔpiào
挂号	guàhào
拐弯	guǎiwān
怪不得	guàibude
管子	guǎnzi
光盘	guāngpán
规模	guīmó
柜台	guìtái
国庆节	Guóqìngjié
国王	guówáng
过敏	guòmǐn
过期	guòqī
海关	hǎiguān
合法	héfǎ
合同	hétong
合影	héyǐng
恨	hèn
花生	huāshēng
划	huá
化学	huàxué
怀孕	huáiyùn
黄金	huángjīn
汇率	huìlǜ
急忙	jímáng
急诊	jízhěn
集合	jíhé
集体	jítǐ
系领带	jì lǐngdài
夹子	jiāzi
嘉宾	jiābīn
假装	jiǎzhuāng
嫁	jià
坚强	jiānqiáng
兼职	jiānzhí
键盘	jiànpán
胶水	jiāoshuǐ
教材	jiàocái
结账	jiézhàng
戒指	jièzhi
进口	jìnkǒu
精力	jīnglì
救护车	jiùhùchē
桔子	júzi
俱乐部	jùlèbù
捐	juān
卡车	kǎchē
看望	kànwang
克	kè
课程	kèchéng
会计	kuàijì
辣椒	làjiāo
老鼠	lǎoshǔ
厘米	límǐ
利息	lìxī
列车	lièchē
零件	língjiàn
零食	língshí
领导	lǐngdǎo
浏览	liúlǎn
录音	lùyīn
论文	lùnwén
麦克风	màikèfēng
贸易	màoyì
眉毛	méimao
秘书	mìshū
蜜蜂	mìfēng
名片	míngpiàn
名胜古迹	míngshèng gǔjì
模特	mótèr
摩托车	mótuōchē
目录	mùlù
内科	nèikē
牛仔裤	niúzǎikù
欧洲	Ōuzhōu
配合	pèihé
披	pī
拼音	pīnyīn
频道	píndào
平方	píngfāng
破产	pòchǎn
欠	qiàn
枪	qiāng
青春	qīngchūn
娶	qǔ
权力	quánlì
权利	quánlì
绕	rào
人口	rénkǒu
人民币	rénmínbì
人事	rénshì
日历	rìlì
日期	rìqī
软	ruǎn
软件	ruǎnjiàn
嗓子	sǎngzi
删除	shānchú
蛇	shé
摄影	shèyǐng
神话	shénhuà
生动	shēngdòng
声调	shēngdiào
省略	shěnglüè
失业	shīyè
狮子	shīzi
时差	shíchā
时髦	shímáo
实习	shíxí
试卷	shìjuàn
收据	shōujù
手工	shǒugōng
手术	shǒushù
手套	shǒutào
寿命	shòumìng
书架	shūjià
鼠标	shǔbiāo
数码	shùmǎ
双方	shuāngfāng
税	shuì
丝绸	sīchóu
撕	sī
搜索	sōusuǒ
宿舍	sùshè
太极拳	tàijíquán
谈判	tánpàn
坦率	tǎnshuài
讨价还价	tǎojià-huánjià
提纲	tígāng
统一	tǒngyī
偷	tōu
土地	tǔdì
土豆	tǔdòu
吐	tǔ
兔子	tùzi
团	tuán
推辞	tuīcí
退	tuì
退步	tuìbù
歪	wāi
玩具	wánjù
往返	wǎngfǎn
围巾	wéijīn
维修	wéixiū
伟大	wěidà
文件	wénjiàn
文学	wénxué
问候	wènhòu
握手	wòshǒu
武术	wǔshù
雾	wù
夏令营	xiàlìngyíng
香肠	xiāngcháng
项链	xiàngliàn
象征	xiàngzhēng
消化	xiāohuà
小麦	xiǎomài
小气	xiǎoqi
血	xiě
信号	xìnhào
信任	xìnrèn
性质	xìngzhì
修改	xiūgǎi
宣布	xuānbù
学历	xuélì
学术	xuéshù
演讲	yǎnjiǎng
宴会	yànhuì
阳台	yángtái
痒	yǎng
议论	yìlùn
硬件	yìngjiàn
优惠	yōuhuì
语气	yǔqì
玉米	yùmǐ
预报	yùbào
预订	yùdìng
乐器	yuèqì
摘	zhāi
粘贴	zhāntiē
展览	zhǎnlǎn
账户	zhànghù
着凉	zháoliáng
哲学	zhéxué
诊断	zhěnduàn
振动	zhèndòng
正	zhēng
证件	zhèngjiàn
政治	zhèngzhì
支票	zhīpiào
执照	zhízhào
制定	zhìdìng
制度	zhìdù
中介	zhōngjiè
周到	zhōudào
主任	zhǔrèn
祝福	zhùfú
专心	zhuānxīn
转告	zhuǎngào
字母	zìmǔ
字幕	zìmù
总理	zǒnglǐ
总统	zǒngtǒng
